# git aliases
alias g="git"
alias gs="git status"
alias gf="git fetch"
alias gb="git branch"
alias gba="git branch -a"
alias gm="git merge"
alias gp="git pull"
alias gpod="git pull origin develop"
alias glg="git l0"
alias gpp="git push"
alias grh="git reset --hard"
alias gc="git clean -dxf"
alias gcr="git clean -dxf && git reset --hard"
alias gsp="git stash pop"
alias gsl="git stash list"
alias gss="git stash save"
alias gsa="git stash apply"
alias gsd="git stash drop"
alias gst="git stash"
alias gco="git checkout"
alias gcob="git checkout -b"
alias gcod="git checkout develop"
alias gcotb="git checkout --track -b"
alias gus="git reset HEAD --"

# cd aliases
alias home="cd /c/git"
alias ble="cd /c/git/ble_env/bledevelop/ble"
alias buildx2="cd /c/git/ble_env/bledevelop/ble/examples/rtos/CC26X2R1_LAUNCHXL/ble5stack/library"
alias ble3="cd /c/git/ble_env/ble3.x/ble"
alias build40="cd /c/git/ble_env/bledevelop/ble/examples/rtos/CC2640R2_LAUNCHXL/ble5stack/library"
alias build403="cd /c/git/ble_env/ble3.x/ble/examples/rtos/CC2640R2_LAUNCHXL/ble5stack/library"
alias bletest="cd /c/git/ble_test_env/ble_test_develop/ble_test"
alias bletest3="cd /c/git/ble_test_env/ble_test_3.x/ble_test"
alias oad="cd /c/git/ble_test_env/ble_test_develop/ble_test/scripts/OAD_Automation"
alias oad3="cd /c/git/ble_test_env/ble_test_3.x/ble_test/scripts/OAD_Automation"
alias ascript="cd /c/git/athena/scripts"
alias custom="cd /c/git_mine/"
alias desktop="cd /c/Users/a0227114/Desktop"

# windows aliases
alias e="explorer ."

# windows shortcuts
alias hci="START '' %userprofile%/Desktop/Shortcuts/'HCITester(elevated).lnk'"
alias dtray="START '' %userprofile%/Desktop/Shortcuts/DuaneTray.lnk"
alias ccs="START '' %userprofile%/Desktop/Shortcuts/CCS7.4.lnk"